w w w w w w w w w w w w w w w w w w w w w w w w w w w
w bb f f f f f f f f f f f f f f f f f f f f f f f br w
w f f f f f f f f f f f f f f f f f f f f f f f f w w
w f f f f f f f f f f f f f f f f f gr f f f f f f f w
w w f f f f f f f f f f f f f f f f f f f f f f f f w
w f f f f f f f f f gg f f f f f gb f f f f f f f f f w
w f f f f f f f f f f f f f f f f w w gy f f f f f f w
w bg f f f f f f f f f f f f f f f f f f f f f f f by w
w w w w w w w w w w w w w w w w w w w w w w w w w w w