w w w w w w w w w w w w w
w f f f f f f f f f f bg w
w f f f f f f f f f f f w
w f f f f bg f f f f f f w
w gg f f f w f f f f f gg w
w w w w w w w w w w w w w